MVP - Minimum Viable Product - Минимально жизнеспособный продукт
RAD - Rapid Application Development
OCR - Optical Character Recognition
RC - Remote Control
AI - Artificial Intelligence - Искусственный интеллект
ACL - Access Control List
DAO - Data Access Object - CRUD методы для конкретной сущности
ACID - набор требований, которые обеспечивают сохранность ваших данных
- Atomicity — Атомарность (транзакции)
- Consistency — Согласованность (достигается за счет транзакций)
- Isolation — Изолированность (блокировка или снапшоты)
- Durability — Надёжность
EOT — End Of Transaction - завершение транзакции
DB - software for sava and get big data
ERD - entity-relationship diagram - диаграмма сущность-связь
PSR - PHP Standards Recommendations
YAGNI - You Aren’t Gonna Need It - Тебе это не понадобится
SLAP - Single Level of Abstraction Principle - Принцип единого уровня абстракций
CTO - Chief technology officer - технический директор
NDA - Non-disclosure agreement - Соглашение о неразглашении
MVVM - Model-View-ViewModel - data+html+dom
XSS - Cross-Site Scripting — межсайтовый скриптинг
PKCE - Proof Key for Code Exchange
UML - Unified Modeling Language — унифицированный язык моделирования
LSB - Late Static Binding - позднее статическое связывание
PDO - PHP Data Objects – это прослойка, которая предлагает универсальный способ работы с несколькими базами данных
FYI - for your information
PEAR - PHP Extension and Application Repository
APC - Alternative PHP Cache — бесплатный и открытый opcode кэшер для PHP
WIP - Work In Progress
RDBMS - stands for Relational Database Management System
gRPC - Remote Procedure Calls
