reduction - сокращение

btw - by the way - кстати
cgi - common gateway interface
sql - structured query language
svg - scalable vector graphics
rss - really simple syndication - простое распространнение по подписке
blob - binary large object
xss - cross-original scripting, "x" use for avoid dificult with match to css (cascading style sheat)
pdo - php data objects
compose - сочинять
owasp - open web application security project
rfc - request for comments
PaaS - playform as a service
FPM - FastCGI process manager
ORM - Object-relational mapping - объектно-реляционная карта(преобразование)
IRC - internet relay chat
PUG - php user group
RPC - remote procedure call
SOAP - simple object access protocol
SAP - system analysis and program development
ERP - enterprise resource planning
UTF - Unicode Transformation Format
HRU - Human Readable Url
URL - Uniform Resource Locator
URI - Uniform Resource Identifier
CI/CD - Continuous Integration / Continuous Delivery
GRASP - General Responsibility Assignment Software Patterns - общие шаблоны распределения ответственностей
WSDL - Web Services Description Language - язык описания веб-сервисов и доступа к ним, основанный на языке XML
UTM - Urchin Tracking Module - еж трекинг модуль
SDK - SoftWare Development Kit
DDD - Domain Driven Design - предметно-ориентированное проектирование
DLL - Dynamic Link Library - библиотека динамической компоновки - многократное использование различными программами
HRM - Human Resource management
ACE - ASCII Compatible Encoding — кодировка совместимая с ASCII
ECMA - European Computer Manufacturers Association
DTO - Data Transfer Object
CORS - Cross Origin Resource Sharing - совместное использование ресурсов между разными источниками
IoC - Inversion of Control 
DI - Dependency Injection
TTL - Time To Live
CSP - Content Security Policy
TDD - Test Driven Development
TST - Total System Testing
CSRF - Сross Site Request Forger - межсайтовая подделка запроса
HMR - Hot Module Replacement - модульное обновление
IDE - Integrated Development Environment - интегрированная среда разработки
HR - Human Resources Manager
VoIP - Voice Over IP - голосовая связь через интернет
