scaffolding - строительные леса
domain - поле деятельности, сфера интересов
leak - протечка
axis - ось
stretch - растягивание
defer - отсрочить
pond - пруд
puny - хилый
widget - штучка
desire - желать
explicit - явный
poison - отрава
agile - проворный
scrum(scrimmage) - потасовка
knob - рукоятка
billing - реклама
data persistence - сохранность данных
bridge - мост
eloquent - красноречивый, убедительный
blade - лезвие, клинок, парень, кончик языка
tinker - жестянщик
lazy loading - загрузка по требованию
compatible - совместимый
errata - ошибка
forgery - подделка
chandelier - люстра
firmware - прошивка
hence - следовательно
defer - откладывать
git - мерзавец
