QA - quality assurance - гарантия качества
notify - уведомлять
scraping - соскоб
parsing - разбор
capes - накидка
expire - истек
redundant - избыточный
assoc - сопоставление
slug - кусок
tile - плитка
rug - коврик
product - произведение (math)
implement - инструмент, средство
trait - характерная черта, особенность
instead - вместо, взамен
except - кроме
stash - спрятать
chunking - свертывание
gist - суть, истинный смыссл
override - перезапись
accordance - соответствии
spare - запасной
processing - обработка
alias - псевдоним
artisan - ремесленник
lint - бинт
recovery - подъем
recession - спад
trough - дно
yield - уступать, принести, привезти
eloquen - убедительный
greeting - приветствие
seed - семя
