slug - бездельник
brute force — грубая сила - подбор пароля перебором
infer - сделать вывод
loan - кредит
upbringing - воспитание
expectation - ожидание, надежда, вероятность, упование, чаяние, предвкушение
maintenance - тех обслуживание
excerpt - выписка
foreign - сторонний
implement - инвентарь
wreak - мстить
assign - назначать
batch - партия, группа, порция
throttle - дроссель, сжимать, прерывать
constraint - принуждение, скованность
attendance - посещаемости
substitute - замена
teaspot - чайник
revoke - отменять
mess - беспорядок
hamble - скромный
acquire - получать
bearer - носильщик
recipient - адресат
bastard - поддонок
skinner - скорняк, жулик
coupling - стыковка
cohesion - спаянность
poop - заливать корму
attendance - посещаемость
proxy - уполномоченный
fate - судьба
destination - предназначение
draft - проект, чертеж
stub - заглушка, талон, корешок
truncate - отсекать
taxonomy - таксономия
haystack - стог сена
